11111111111111
10000100000001
1C00000C0E0001
101P0100000011
11111111111111
