11111111111111
10000000000101
1C00P00C0E0011
10100100000001
11111111111111
