1111111111111111111111111111111
1111001100C1000000C00011C111111
100000C00000C00001110000010E111
100P000110001100011111000001111
1111111111111111111111111111111
