111111111111111111111
110C00000001000000011
10010C01C001001100C11
1P00C00000E0C10001111
111100000000010111111
111111111111111111111
