11111111111111
100000C00000C1
1000P0000011E1
1001C111111111
11111111111111
