111111111
100C00011
100E00P01
111111111
